# HaverQuest Map Level 1
# G -- Grass
# B -- Grey brick
# R -- Red brick
# Unsolvable in some circumstances
GGGGGGGGGGRGGGGGGGGG
GGGGGGGGGGRGGGGGGGGG
GGGGGGGGGGGGGGGGGGGG
GGGGGGGGGGRRRRRRRRRR
GGBBGGGGGGGGGGGGGGGG
GGGGGGGGGGGGGGGGGGGG
GGGGGRRRGGGGGGGGGGGG
GGGGGGGGBBBGGGGGGGGG
GGGGGGGGGGGRRGGGGGGG
GGGGGGGGGGGGGGGGGGGG
GGGGGGGGGGGGGBBBBBGG
GGGGGGGGGGGGGGGGGGGG
BBBBBGGGGGGGGGGGGGGG
GGGRGGGGGGGGGGGGGGGG
GGGRGGGGGGGGGGGGGGGG
GGGRGGGGGGGGGGGGGGGG
GGGGGGGGGGGGGGGGGGGG
GGGRGGGGGGGGGGGGGGGG
GGGRGGGGGGGGGGGGGGGG
GGGRGGGGGGGGGGGGGGGG
